index,Date,Labor Force,Employment,Unemployment,Unemployment Rate
0,1/1/2019,761954,733742,28212,3.7
1,2/1/2019,763333,738485,24848,3.3
2,3/1/2019,763394,738847,24547,3.2
3,4/1/2019,762903,740887,22016,2.9
4,5/1/2019,772703,749174,23529,3
5,6/1/2019,783116,755580,27536,3.5
6,7/1/2019,788421,759749,28672,3.6
7,8/1/2019,787675,760743,26932,3.4
8,9/1/2019,790552,765982,24570,3.1
9,10/1/2019,788506,764415,24091,3.1
10,11/1/2019,784652,761806,22846,2.9
11,12/1/2019,785081,764071,21010,2.7
12,1/1/2020,782099,757621,24478,3.1
13,2/1/2020,783439,762151,21288,2.7
14,3/1/2020,771884,739103,32781,4.2
15,4/1/2020,709505,634511,74994,10.6
16,5/1/2020,759146,676599,82547,10.9
17,6/1/2020,768045,699410,68635,8.9
18,7/1/2020,787553,709874,77679,9.9
19,8/1/2020,780753,726341,54412,7
20,9/1/2020,788330,737281,51049,6.5
21,10/1/2020,789367,745538,43829,5.6
22,11/1/2020,785591,744201,41390,5.3
23,12/1/2020,785623,746352,39271,5
24,1/1/2021,780522,740675,39847,5.1
25,2/1/2021,782293,745922,36371,4.6
26,3/1/2021,784664,750094,34570,4.4
27,4/1/2021,784954,752494,32460,4.1
28,5/1/2021,792430,760777,31653,4
29,6/1/2021,801535,764473,37062,4.6
30,7/1/2021,804311,768681,35630,4.4
31,8/1/2021,805271,771594,33677,4.2
32,9/1/2021,808756,778122,30634,3.8
33,10/1/2021,809772,780470,29302,3.6
34,11/1/2021,809414,781810,27604,3.4
35,12/1/2021,810170,786136,24034,3
36,1/1/2022,810629,781638,28991,3.6
37,2/1/2022,810845,785358,25487,3.1
38,3/1/2022,815218,791669,23549,2.9
39,4/1/2022,816421,794416,22005,2.7
40,5/1/2022,824617,801836,22781,2.8
41,6/1/2022,830343,803507,26836,3.2
42,7/1/2022,833739,807788,25951,3.1
43,8/1/2022,835093,809135,25958,3.1
44,9/1/2022,836491,813293,23198,2.8
45,10/1/2022,835016,811973,23043,2.8
46,11/1/2022,826818,804223,22595,2.7
47,12/1/2022,827949,808017,19932,2.4
48,1/1/2023,828876,805226,23650,2.9
49,2/1/2023,829997,807054,22943,2.8
50,3/1/2023,836013,813320,22693,2.7
51,4/1/2023,836907,816349,20558,2.5
52,5/1/2023,843740,820166,23574,2.8
53,6/1/2023,852774,825089,27685,3.2
54,7/1/2023,851784,823852,27932,3.3
55,8/1/2023,855574,826255,29319,3.4
56,9/1/2023,854872,827602,27270,3.2
57,10/1/2023,854462,826801,27661,3.2
58,11/1/2023,851799,825372,26427,3.1
59,12/1/2023,847996,822867,25129,3
60,1/1/2024,844054,815556,28498,3.4
61,2/1/2024,845155,817144,28011,3.3
62,3/1/2024,849495,822003,27492,3.2
63,4/1/2024,850244,824686,25558,3
64,5/1/2024,853580,826291,27289,3.2
65,6/1/2024,862964,830624,32340,3.7
66,7/1/2024,865860,831773,34087,3.9
67,8/1/2024,864753,831589,33164,3.8
68,9/1/2024,864863,834471,30392,3.5
69,10/1/2024,860903,830736,30167,3.5
70,11/1/2024,855033,824733,30300,3.5
71,12/1/2024,854593,827379,27214,3.2
72,1/1/2025,858073,825453,32620,3.8
73,2/1/2025,853710,821180,32530,3.8
,,,,,
